%%%%%%%%%%%
% ...o... %
%.% %.% %.%
% % %.% % %
%    .    %
% % %.% % %
%.........%
% %%%.%%% %
%... P ...%
% %.....% %
%G%o%.%o% %
% % %.% % %
% % %.% % %
%    .    %
%.%%%.%%% %
%.........%
%.%o...o%.%
%.%%%.%%%.%
% ... ....%
%%%%%%%%%%%
