%%%%%%%%%%%
%o...P...o%
%.%.%%%%%.%
%.%.....%.%
%...%.%...%
%%%.%.%.%%%
%.........%
%.%.%%%.%.%
%.%    .%.%
%..  o%...%
%..  .%...%
%.%    .%.%
%.%%%%%.%.%
%G.......G%
%%%.%%%.%%%
%...%.....%
%.%...%.%.%
%.%.%%%.%.%
%o.......o%
%%%%%%%%%%%
