%%%%%%%%%%%
% ... ... %
% ...G... %
%.........%
%.   .   .%
%.   .   .%
%.........%
% ... ... %
% ... ... %
%         %
% ... ... %
% ... ... %
%........ %
%.   .   .%
%.   .   .%
%.........%
% ...P....%
% ... ... %
%        o%
%%%%%%%%%%%
