%%%%%%%%%%%
% ... ...G%
% ... ... %
%.........%
%.   .   .%
%.   .   .%
%.........%
% ... ... %
% ...o... %
%         %
% ...o... %
% ... ... %
%........ %
%.   .   .%
%.   .   .%
%.........%
% ... ....%
% ... ... %
%P        %
%%%%%%%%%%%
