%%%%%%%%%
%   .   %
% %% %% %
% %  G% %
%.  %  .%
% %P %% %
% %% %% %
%   .   %
%%%%%%%%%
