%%%%%%%%%%%%%%%
%%%%%%.%.%%%%%%
%         G  P%
% %%%%%.%.%%% %
%  %%%%%%%%%% %
%             %
%%%%%%%%%%%%%%%
