%%%%%%%%
%G    P%
%%% %% %
%  ..% %
% %..% %
% %%%% %
%      %
%%%%%%%%
