%%%%%%%%%%%%%
%%%%%%G%%%%%%
%%%%%% %%%%%%
%%%%%% %%%%%%
%%%%%% %%%%%%
%%%%%.  %%%%%
%.         .%
%%%%%  .%%%%%
%%%%%% %%%%%%
%%%%%% %%%%%%
%%%%%% %%%%%%
%%%%%%P%%%%%%
%%%%%%%%%%%%%
