%%%%%%%%%%%%
%.% G  %  .%
%   %    % %
%.  P %   .%
%%%%%%%%%%%%
