%%%%%%%
%.   .%
%     %
% P G %
%     %
%.   .%
%%%%%%%
