%%%%%%%
%P . G%
% %.% %
%  %  %
%%. .%%
%%%%%%%
