%%%%%%
%.  .%
% G  %
% %P %
%.  .%
%%%%%%
