%%%%%%%%%
%     .%%
%P%.%.%%%
%%G    .%
%%%%%%%%%
