%%%%%%%
%. G .%
% %%% %
% %P% %
%.   .%
%%%%%%%
