%%%%%%%%%%%%%%%%%%%%%%%%%%%%%%
%.                           %
%%%%%%%%%%%%%%%%%%%%%%%%%%%% %
%                            %
% %%%%%%%%%%%%%%%% %%%%%%%%%%%
%         %G .. G%           %
%%%%%%%%% %      %%%%%%%%%%% %
%           .GG             P%
% %%%%%%% %      %%%%%%%%%%% %
% %       %G .. G%           %
% %%G%G%% %%%%%%%% %%%%%%%%%%%
%.                           %
%%%%%%%%%%%%%%%%%%%%%%%%%%%% %
%.                           %
%%%%%%%%%%%%%%%%%%%%%%%%%%%%%%
