%%%%%%%%%%%%%%%%%%%%%%
%                   P%
% %%%%%%%%%%%%%%%%%% %
%                  G %
%%%%%%%%%%% %%%%%% % %
%                  G %
% %%%%%%%%%%%%%%%% % %
%                  G %
%%%%%%%%%%% %%%%%% % %
%                   .%
%%%%%%%%%%%%%%%%%%%%%%
