%%%%%%%%%%%%%%%%%
%P              %
% %%%%%%%%%% %% %
% G%.        G% %
% G%%%%%%%%% %% %
%.          .  .%
%%%%%%%%%%%%%%%%%
