%%%%%%%%%%%%%%%%%
%P             .%
% %%%%%%%%% %GG%%
% %%.          .%
% %G%%%%%%%%%GG %
%               %
%%%%%%%%%%%%%%%%%
