%%%%%%%%%%%%%%%%%
%P             .%
%%%%%%%%%% %GGG%%
%.              %
%%GG% %%%%%%%%G%%
%              .%
%%%%%%%%%%%%%%%%%
